10?#=
?##?###???
???#?????#
?##???????
#?#??##?#?
???????#?#
?#???##??#
?#?????#?#
??????#?#?
#???###??#
??????#???
